; LabMidnight editable map layout.
; Generated by map_editor.py for floor 3. One character is one 60cm floor tile.
;
; Terrain: # wall, . floor, @ player start
; Doors: L lab, M machine/server lab-style, C classroom, G guard, P power, E exit
; Objects: 1-9 story objects defined in src/map_data.py

############################################################################
#....#...........#....#...........#....#...........#....#...........#...##.#
#.6..#...........#.6..#.....6.....#....#...........#....#...........#...##.#
#.6..#6...66.....#.6..#.......6...#.@..#...6.......#....#...........##E###.#
#.6.6#..6666.....#.6..#..6.6..6...#.1..#..........6#....#..................#
#.66.#...666666..#.6..#...........#....#...........#....#..................#
#.6..#...6666....#.6..#........6..#....#.....6.....#.6..#....6.............#
#....#...........#.6..#...........#....#...........#....#..................#
#....#...........L....#....6......L....#...........L....#..................#
####L#L#########L####L#L#########L####L#L#########L####L#..................#
#..........................................................................#
#..............66.6....6.6................6................................#
#..........................................................................#
####L#L#########L####L#L#########L####L#.....6.............................#
#....#...........L....#.6.........L....#....................6..............#
#..6.#...........#....#...........#.6..#.............6......6..............#
#.66.#..666...6..#..6.#......6....#....#...................................#
#.66.#........66.#..6.#......6.66.#....#.....6...............###########...#
#.66.#.........6.#..6.#...........#....#.....................#...C.........#
#.66.#........6..#..6.#...6.......#....#.....................#...#C###C#...#
#.6..#..66.666...#..6.#...6..6....#..6.#..........66.........#...#.#6#.#...#
#....#...........#..6.#...6.......#.6..#.....................#...#.#.#.#...#
#....#...........#....#.........6.#.6..#.....................#...#.#...#...#
############################################################################
