; LabMidnight editable map layout.
; Generated by map_editor.py for floor 4. One character is one 60cm floor tile.
;
; Terrain: # wall, . floor, @ player start
; Doors: L lab, M machine/server lab-style, C classroom, G guard, P power, E exit
; Objects: 1-9 story objects defined in src/map_data.py

####################################################################################################
#...#....#..........#..........#####################################################################
#...#....#.3........#.......2..#####################################################################
#.@.#....#..........#..........#####################################################################
#.1.#....#..........#..........#####################################################################
#...#....#..........#..........#####################################################################
##L###L####C######C###C######C######################################################################
#................................###################################################################
#................................###################################################################
####G#####P##..######M#######E######################################################################
#.......#...#..####......##......###################################################################
#.....9.#.7.#..####......##......###################################################################
#..4....#P###..####..8...##......###################################################################
#....5..#...#..####......##......###################################################################
#.......#...#..####......##......###################################################################
####G#####P##..#####################################################################################
#................................###################################################################
#................................###################################################################
####################################################################################################
####################################################################################################
####################################################################################################
####################################################################################################
####################################################################################################
####################################################################################################
