; LabMidnight editable map layout.
; Generated by map_editor.py for floor 1. One character is one 60cm floor tile.
;
; Terrain: # wall, . floor, @ player start
; Doors: L lab, M machine/server lab-style, C classroom, G guard, P power, E exit
; Legacy objects: 1-9 story objects defined in src/map_data.py
; Custom objects are stored in the floor metadata JSON.

############################################################################
#....#....#......................#......................#...........#....#.#
#....#....#......................#......................#...........#....#.#
#....#....#......................#......................#...........########
E....#....#.............................................#..................#
E....#....#.............................................#..................#
#....#....#.............................................C..................#
#....#....#.............................................C..................#
#....######.............................................#..................#
#.........#.............................................#..................#
#.........C......................#....................3.#..................#
#.........C......................#....................3.#..................#
#.........#......................#......................#..................#
############################################################G#.............#
#....###################################################.....#.............#
#....###################################################.....#.............#
#....###################################################.....#.............#
#....###################################################.....#.............#
#....###################################################.....#.............#
#....###################################################.....#.............#
#....###################################################.....###########...#
#....###################################################.....#...C.........#
#....###################################################.....#...#C###C#...#
##############################################################...#.#.#.#...#
##############################################################...#.#.#.#...#
##############################################################...#.#...#...#
############################################################################
