; LabMidnight editable map layout.
; Generated by map_editor.py for floor 4. One character is one 60cm floor tile.
;
; Terrain: # wall, . floor, @ player start
; Doors: L lab, M machine/server lab-style, C classroom, G guard, P power, E exit
; Legacy objects: 1-9 story objects defined in src/map_data.py
; Custom objects are stored in the floor metadata JSON.

########################################################################################################################################################
########################################################################################################################################################
##........##......................##........##......................##......@.##......................##........##......................##........##..##
##........##......................##........##......................##........##......................##........##......................##........##..##
##........##......................##........##......................##........##......................##........##......................##........##..##
##........##......................##........##......................##........##......................##........##......................##........##..##
##........##......................##........##......................##........##......................##........##......................####EEEE####..##
##........##......................##........##......................##........##......................##........##......................####EEEE####..##
##........##........2.............##..5.....##..........7...........##........##....................6.##........##..............................9.....##
##........##......................##........##......................##........##......................##........##....................................##
##........##......................##........##......................##........##......................##........##....................................##
##........##......................##........##......................##........##......................##........##....................................##
##........##......................##........##......................##........##......................##..6.....##........6...........................##
##........##......................##........##......................##........##......................##........##....................................##
##........##......................##........##......................##........##......................##........##....................................##
##........##......................##........##......................##........##......................##........##....................................##
##........##......................LL........##......................LL........##......................LL........##....................................##
##........##......................LL........##......................LL........##......................LL........##....................................##
########LL##LL##################LL########LL##LL##################LL########LL##LL##################LL########LL##....................................##
########LL##LL##################LL########LL##LL##################LL########LL##LL##################LL########LL##....................................##
##....................................................................................................................................................##
##....................................................................................................................................................##
##....................................................................................................................................................##
##....................................................................................................................................................##
##....................................................................................................................................................##
##....................................................................................................................................................##
########LL##LL##################LL########LL##LL##################LL########LL##......................................................................##
########LL##LL##################LL########LL##LL##################LL########LL##......................................................................##
##........##......................LL........##......................LL........##........................................6.............................##
##........##......................LL........##......................LL........##......................................................................##
##........##......................##........##......................##........##..........................6.............6.............................##
##........##......................##........##......................##........##......................................................................##
##........##......................##........##......................##........##......................................................................##
##........##......................##........##......................##........##......................................................................##
##........##......................##..6.....##......................##........##..........................................######################......##
##........##......................##........##......................##........##..........................................######################......##
##..3.....##........4.............##........##........8.............##........##..........................................##......CC..................##
##........##......................##........##......................##........##..........................................##......CC..................##
##........##......................##........##......................##........##..........................................##......##CC######CC##......##
##........##......................##........##......................##........##..........................................##......##CC######CC##......##
##........##......................##........##......................##........##....................6.6...................##..9...##..##6.##..##......##
##........##......................##........##......................##........##..........................................##......##..##..##..##......##
##........##......................##........##......................##........##..........................................##......##..##..##..##......##
##........##......................##........##......................##........##..........................................##......##..##..##..##......##
##........##......................##........##......................##........##..........................................##......##..##......##......##
##........##......................##........##......................##........##..........................................##......##..##......##......##
########################################################################################################################################################
########################################################################################################################################################
